~~~~~~~~~
~.......~
~.......~
~..=====~
~.......~
~~~~~~~~~