~~~~~~~~~~~~~
~=====......~
~=======..==~
~...........~
~======..===~
~........===~
~~~~~~~~~~~~~